aardvark|medium-sized, burrowing, nocturnal mammal native to Africa
abalone|an edible mollusk of warm seas, with a shallow ear-shaped shell lined with mother-of-pearl and pierced with a line of respiratory holes
aberration|a state or condition markedly different from the norm
abject|of the most contemptible kind
abjure|formally reject or disavow a formerly held belief
abnegation|the denial and rejection of a doctrine or belief
abrogate|revoke formally
abscond|run away, often taking something or somebody along
abstruse|difficult to understand
accede|yield to another's wish or opinion
accost|approach and speak to someone aggressively or insistently
accretion|an increase by natural growth or addition
acerbic|harsh or corrosive in tone
acumen|shrewdness shown by keen insight
adage|a condensed but memorable saying embodying some important fact of experience that is taken as true by many people
adamant|impervious to pleas, persuasion, requests, or reason
admonish|scold or reprimand; take to task
adroit|quick or skillful or adept in action or thought
adulation|exaggerated flattery or praise
adumbrate|describe roughly or give the main points or summary of
adverse|in an opposing direction
advocate|a person who pleads for a person, cause, or idea
aeolian|relating to or arising from the action of the wind
affidavit|a written statement sworn to be true before someone legally authorized to administer an oath
affluent|having an abundant supply of money or possessions of value
aggrandize|embellish; increase the scope, power, or importance of
alacrity|liveliness and eagerness
alfalfa|leguminous plant grown for hay or forage
alias|a name that has been assumed temporarily
allegory|a short moral story, often with animal characters
amalgam|a combination or blend of diverse things
ambivalent|uncertain or unable to decide about what course to follow
ameliorate|make better
amenable|disposed or willing to comply
amorphous|having no definite form or distinct shape
anachronistic|chronologically misplaced
analgesic|a medicine used to relieve pain
anathema|a formal ecclesiastical curse accompanied by excommunication
anchovy|small herring-like plankton-eating fish often canned whole or as paste
annex|attach to
anoint|administer an oil or ointment to; choose by or as if by divine intervention
antecedent|someone from whom you are descended
antediluvian|of or relating to the period before the biblical flood
antiseptic|thoroughly clean and free of disease-causing organisms
antithesis|exact opposite
apathetic|showing little or no emotion or animation
aperitif|alcoholic beverage taken before a meal as an appetizer
apocryphal|being of questionable authenticity
apoplectic|marked by extreme anger
aposiopesis|the device of suddenly breaking off in speech
approbation|official acceptance or agreement
arbitrary|based on or subject to individual discretion or preference
arboreal|of or relating to or formed by trees
arcane|requiring secret or mysterious knowledge
archetypal|of an original type after which other things are patterned
archipelago|a group of many islands in a large body of water
ardent|characterized by intense emotion
arraign|call before a court to answer an indictment
arrogate|seize and take control without authority
arrondissement|a subdivision of a French department, for local government administration
ascertain|learn or discover with certainty
ascetic|someone who practices self denial as a spiritual discipline
aspersion|a disparaging remark
assiduous|marked by care and persistent effort
assuage|provide physical relief, as from pain
astringent|a drug that causes contraction of body tissues and canals
astute|marked by practical hardheaded intelligence
atoll|an island consisting of a circular coral reef surrounding a lagoon
atrophy|a decrease in size of an organ caused by disease or disuse
attache|a specialist assigned to the staff of a diplomatic mission
aubergine|the purple fruit of a tropical plant in the nightshade family; an eggplant
auguring|favorable circumstances and good luck
augur|predict from an omen|auspicious
avarice|reprehensible acquisitiveness; insatiable desire for wealth
avuncular|resembling an uncle in kindness or indulgence
axiom|a saying that is widely accepted on its own merits
bailiff|an officer of the court who is employed to execute writs and processes and make arrests
balk|refuse to comply
balmy|mild and pleasant
banal|repeated too often; overfamiliar through overuse
banana|elongated, edible fruit – botanically a berry – produced by several kinds of large herbaceous flowering plants in the genus Musa
bane|something causing misery or death
bankruptcy|a state of complete lack of some abstract property
baobab|an African tree with an exceedingly thick trunk
barbiturate|organic compound having powerful soporific effect
barrage|the heavy fire of artillery to saturate an area rather than hit a specific target
bashful|self-consciously timid
bastion|projecting part of a rampart or other fortification
bayou|a swampy arm or slow-moving outlet of a lake
bedlam|a state of extreme confusion and disorder
bedraggled|limp and soiled as if dragged in the mud
beguile|influence by slyness
behoove|be appropriate or necessary
beige|a light greyish-brown color
bellicose|having or showing a ready disposition to fight
bequeath|leave or give, especially by will after one's death
bequest|a gift of personal property by will
bereft|sorrowful through loss or deprivation
beseech|ask for or request earnestly
besmirch|smear so as to make dirty or stained
bezoar|a small stony concretion that may form in the stomachs of certain animals, especially ruminants, once used as an antidote for various ailments
bifurcated|divided into or made up of two parts
bigamy|the offense of marrying someone while you have a living spouse from whom no valid divorce has occurred
bilk|cheat somebody out of what is due, especially money
billow|rise and move heavily but fluidly
bisque|a thick cream soup made from shellfish
blandishment|flattery intended to persuade
blasphemy|profane language
blithe|carefree and happy and lighthearted
blitzkrieg|a swift and violent military offensive with intensive aerial bombardment
blunder|an embarrassing mistake
bobbin|a cylinder around which thread, tape, film or other flexible materials can be wound
bodice|part of a dress above the waist
bombastic|ostentatiously lofty in style
bombilate|make a buzzing sound
boniface|the proprietor of a hotel or restaurant; an innkeeper
boudoir|a woman's bedroom or private room
bowdlerize|edit by omitting or modifying parts considered indelicate
braggadocio|vain and empty boasting
bramble|any of various rough thorny shrubs or vines
bravado|a swaggering show of courage
brazen|unrestrained by convention or propriety
brindle|having a grey or brown streak, pattern or patchy coloring; used especially for cats
brouhaha|loud confused noise from many sources
brusque|marked by rude or peremptory shortness
bucolic|idyllically rustic
bungalow|a small house with a single story
buoyant|floating on a liquid or rising in air or gas
burgeon|grow and flourish
burlap|coarse jute fabric
bursar|the treasurer at a college or university
bushel|a United States dry measure equal to 4 pecks or 2152.42 cubic inches
butte|a hill with a flat top and sloping sides that rises abruptly from the surrounding terrain
cache|a hidden storage space
cacophonous|having an unpleasant sound
cactus|a succulent plant with a thick, fleshy stem that typically bears spines, lacks leaves, and has brilliantly colored flowers
cajole|influence or urge by gentle urging, caressing, or flattering
callipygian|pertaining to or having finely developed buttocks
callous|emotionally hardened
calumny|a false accusation of an offense
camaraderie|the quality of affording easy familiarity and sociability
candor|the quality of being honest and straightforward
cantankerous|stubbornly obstructive and unwilling to cooperate
capitulate|surrender under agreed conditions
capricious|determined by chance or impulse rather than by necessity
carafe|a bottle with a stopper; for serving wine or water
carouse|engage in boisterous, drunken merrymaking
carp|any of various freshwater fish of the family Cyprinidae
castigate|inflict severe punishment on
cataclysm|a sudden violent change in the earth's surface
caucus|meet to select a candidate or promote a policy
caustic|capable of destroying or eating away by chemical action
cavort|play boisterously
cerise|a bright or deep red color
chagrin|strong feelings of embarrassment
chamois|a soft suede leather formerly from the skin of the chamois antelope
chamomile|Eurasian plant with apple-scented foliage and feathery leaves used medicinally
chanteuse|a female singer of popular songs, especially in a nightclub
chassis|the base frame of a motor vehicle or other wheeled conveyance
chickadee|a small gray-and-black North American titmouse
chiffon|a sheer fabric of silk or rayon
chimerical|produced by a wildly fanciful imagination
chivalrous|being attentive to women like an ideal knight
chortle|a soft partly-suppressed laugh
chrysanthemum|a plant of the daisy family with brightly colored ornamental flowers
chutzpah|unbelievable gall; insolence; audacity
circuitous|deviating from a straight course
circumlocution|an indirect way of expressing something
circumscribe|draw a geometric figure around another figure
circumvent|surround so as to force to give up
cirrhosis|a chronic disease of the liver, especially from alcoholism or hepatitis
cistern|an artificial reservoir for storing liquids, specifically rainwater
clairvoyant|a person who claims to have a supernatural ability to perceive events in the future
clamor|utter or proclaim insistently and noisily
clandestine|conducted with or marked by hidden aims or methods
cleave|separate or cut with a tool, such as a sharp instrument
clemency|leniency and compassion shown toward offenders
coagulate|change from a liquid to a thickened or solid state
cobbler|a person who makes or repairs shoes
coccyx|the end of the vertebral column in humans and tailless apes
cochlea|the snail-shaped tube where sound vibrations are converted into nerve impulses
cogent|powerfully persuasive
cognizant|having or showing knowledge or understanding or realization
comeuppance|an outcome (good or bad) that is well deserved
commensurate|corresponding in size or degree or extent
commiserate|feel or express sympathy or compassion
commodious|large and roomy
complement|something added to embellish or make perfect
compunction|a feeling of deep regret, usually for some misdeed
concede|admit or acknowledge, often reluctantly
conciliatory|making or willing to make concessions
conclave|a confidential or secret meeting
concomitant|following or accompanying as a consequence
conduit|a passage through which water or electric wires can pass
confabulate|talk socially without exchanging too much information
conflagration|a very intense and uncontrolled fire
confluence|a place where things merge or flow together
congeal|become gelatinous
congruity|the quality of agreeing; being suitable and appropriate
connive|form intrigues (for) in an underhand manner
connoisseur|an expert able to appreciate a field, especially in the fine arts
consign|give over to another for care or safekeeping
conspicuous|obvious to the eye or mind
consternation|sudden shock or dismay that causes confusion
constituent|one of the individual parts making up a composite entity
construe|make sense of; assign a meaning to
consummate|having or revealing supreme mastery or skill
contemporaneous|occurring in the same period of time
contentious|showing an inclination to disagree
contravene|go against, as of rules and laws
contrite|feeling or expressing pain or sorrow for sins or offenses
contusion|an injury in which the skin is not broken
conundrum|a difficult problem
convivial|occupied with or fond of the pleasures of good company
copious|large in number or quantity
copula|an equating verb (such as 'be' or 'become') that links the subject with the complement of a sentence
coquille|seafood served in a scallop shell; a dish in the form of a scallop shell
corduroy|a cut pile fabric with vertical ribs; usually made of cotton
corpulence|the property of excessive fatness
corrugated|shaped into alternating parallel grooves and ridges
corsage|a spray of flowers worn pinned to a woman's clothes
countenance|the appearance conveyed by a person's face
coup|a sudden and decisive change of government by force
covet|wish, long, or crave for
cravat|neckwear worn in a slipknot with long ends overlapping vertically in front; a necktie
credence|the mental attitude that something is believable
crevasse|a deep fissure, especially one in a glacier
culpable|deserving blame or censure as being wrong or injurious
cupidity|extreme greed for material wealth
curtail|terminate or abbreviate before its intended or proper end
cymbal|a percussion instrument consisting of a concave brass disk
cynical|believing the worst of human nature and motives
daffodil|a bulbous plant that typically bears bright yellow flowers with a long trumpet-shaped corona
daub|coat or smear with a thick or sticky substance in a carelessly rough or liberal way
dawdle|take one's time; proceed slowly
dearth|an insufficient quantity or number
debacle|a sudden and complete disaster
debauch|a wild gathering involving excessive drinking
debunk|expose while ridiculing
debutante|a young woman making her debut into society
deciduous|shedding foliage at the end of the growing season
decisive|settling an issue; producing a definite result
deft|skillful in physical movements, especially of the hands
defunct|no longer in force or use; inactive
deign|do something that one considers to be below one's dignity
deleterious|harmful to living things
deluge|the rising of a body of water and its overflowing onto land
demagogue|a leader who seeks support by appealing to popular passions
demerit|a quality or feature deserving censure
denigrate|attack the good name and reputation of someone
deprecate|express strong disapproval of; deplore
derelict|in a very poor condition as a result of disuse and neglect
derivative|a compound obtained from another compound
descry|catch sight of
despot|a cruel and oppressive dictator
destitute|poor enough to need help from others
devout|deeply religious
diabolical|showing the cunning or ingenuity or wickedness typical of a devil
diaphanous|so thin as to transmit light
diatreme|a long vertical pipe or plug formed by gas-filled magma forced up through overlying strata
diatribe|thunderous verbal attack
didactic|instructive, especially excessively
diffident|lacking self-confidence
dilapidated|in a state of disrepair or ruin as a result of age or neglect, usually of a building
dilettante|an amateur engaging in an activity without serious intention
diminutive|a shortened form of a name, typically used informally
diphthong|a sound formed by the combination of two vowels in a single syllable, in which the sound begins as one vowel and moves toward another
dirge|a song or hymn of mourning as a memorial to a dead person
disaffected|discontented as toward authority
disavow|refuse to acknowledge; disclaim knowledge of, responsibility for, or association with
discern|distinguish with difficulty by sight or with the other senses
discomfit|cause to lose one's composure
discordant|not in agreement or harmony
discrepancy|a difference between conflicting facts or claims or opinions
disgruntled|in a state of sulky dissatisfaction
disheveled|in disarray; extremely disorderly
dismal|causing dejection
dismay|the feeling of despair in the face of obstacles
disparate|fundamentally different or distinct in quality or kind
dispel|cause to separate and go in different directions
disrepute|the state of being held in low esteem
disseminate|cause to become widely known
dissident|a person who opposes official policy, especially that of an authoritarian state
dissipate|cause to separate and go in different directions
dissonance|the auditory experience of sound that lacks musical quality
dissuade|turn away from by persuasion
distend|swell from or as if from internal pressure
distraught|deeply agitated especially from emotion
dither|act nervously; be undecided; be uncertain
divisive|causing or characterized by disagreement or disunity
divulge|make private or sensitive information known publicly
dogmatic|pertaining to a code of beliefs accepted as authoritative
doldrums|a belt of calm winds between the trade winds of the Atlantic and Pacific; a state of inactivity or stagnation
doleful|filled with or evoking sadness
domicile|housing that someone is living in
dossier|a collection of papers containing detailed information about a particular person or subject
dour|showing a brooding ill humor
dowdy|lacking in smartness or taste; out of date
draconian|excessively harsh and severe
dredge|clean out the bed of a harbor, river, or other area of water
drudgery|hard, monotonous, routine work
dubious|fraught with uncertainty or doubt
duplicity|the act of deceiving or acting in bad faith
duress|compulsory force or threat
dwindle|become smaller or lose substance
dysentery|an infection of the intestines marked by severe diarrhea
ebullient|joyously unrestrained
ecclesiastical|of or associated with a church, especially a Christian Church
echelon|position in a social hierarchy
eclair|an oblong cream puff
eclectic|selecting what seems best of various styles or ideas
ecru|a very light brown color of unbleached linen
ecumenical|concerned with promoting unity among churches or religions
edict|a formal or authoritative proclamation
edify|make understand
efface|remove by or as if by rubbing or erasing
effervescent|marked by high spirits or excitement
effigy|a representation of a person, especially in the form of sculpture
effulgent|radiating or as if radiating light
effusive|uttered with unrestrained enthusiasm
egalitarian|favoring social equality
egregious|conspicuously and outrageously bad or reprehensible
elegy|a mournful poem; a lament for the dead
elicit|call forth, as an emotion, feeling, or response
elixir|a substance believed to cure all ills
elongated|unusually long in relation to its width
elucidate|make clear and comprehensible
emaciated|very thin especially from disease or hunger or cold
emanate|proceed or issue forth, as from a source
embalm|preserve a dead body
embargo|a government order imposing a trade barrier
embellish|make more attractive, as by adding ornament or color
embezzlement|the fraudulent appropriation of funds or property
emblazon|decorate with heraldic arms
embroil|force into some kind of situation, condition, or course of action
emend|make corrections to
emeritus|a professor or minister who is retired from assigned duties
eminent|standing above others in quality or position
emissary|someone sent on a mission to represent the interests of someone else
emollient|a substance with a soothing effect when applied to the skin
emphatic|forceful and definite in expression or action
empirical|derived from experiment and observation rather than theory
emulate|strive to equal or match, especially by imitating
encumber|hold back, impede, or weigh down
endorheic|(of a lake or basin) internally drained; having no outlet
enervate|weaken mentally or morally
enfranchise|grant freedom to, as from slavery or servitude
engender|call forth
engross|devote oneself fully to
enigma|something that baffles understanding and cannot be explained
enmity|a state of deep-seated ill-will
ennui|the feeling of being bored by something tedious
ensconce|fix firmly
enthrall|hold spellbound
entreat|ask for or request earnestly
enunciate|express or state clearly
envisage|form a mental image of something that is not present or that is not yet the case
epaulet|adornment consisting of an ornamental cloth pad worn on the shoulder
ephemeral|anything short-lived, as an insect that lives only for a day
epiphany|an inspiration or divine manifestation
epistolary|written in the form of letters or correspondence
epitaph|an inscription on a tombstone or monument in memory of the person buried there
epithet|descriptive word or phrase
epitome|a standard or typical example
epoch|a period marked by distinctive character
equanimity|steadiness of mind under stress
equivocal|open to two or more interpretations
erratic|liable to sudden unpredictable change
erroneous|containing or characterized by error
escapade|any carefree episode
eschew|avoid and stay away from deliberately
esoteric|understandable only by an enlightened inner circle
espouse|choose and follow a theory, idea, policy, etc.
ethereal|characterized by lightness and insubstantiality; as impalpable or intangible as air
eulachon|a small edible marine fish with oily flesh, occurring on the west coast of North America; a candlefish
eunuch|a man who has been castrated, historically one employed to guard the women's living areas at an oriental court
euphemism|an inoffensive expression substituted for an offensive one
evanescent|tending to vanish like vapor
evince|give expression to
exacerbate|make worse
exalt|fill with sublime emotion
excise|remove by cutting
excoriate|express strong disapproval of
excrement|waste matter, especially feces, discharged from the body
exculpate|pronounce not guilty of criminal charges
excursion|a journey taken for pleasure
execrable|unequivocally detestable
exhort|spur on or encourage especially by cheers and shouts
exhume|dig up for reburial or for medical investigation of dead bodies
exigent|demanding immediate attention
exonerate|pronounce not guilty of criminal charges
exorbitant|greatly exceeding bounds of reason or moderation
expatiate|add details, as to an account or idea
expatriate|a person who is voluntarily absent from home or country
expectorate|discharge from the lungs and out of the mouth
expedient|appropriate to a purpose
expiate|make amends for
expiate|make amends for
expletive|profane or obscene expression usually of surprise or anger
expository|serving to expound or set forth
expunge|remove by erasing or crossing out or as if by drawing a line
expurgate|edit by omitting or modifying parts considered indelicate
extant|still in existence; not extinct or destroyed or lost
extemporaneous|with little or no preparation or forethought
extirpate|destroy completely, as if down to the roots
extol|praise, glorify, or honor
extol|praise, glorify, or honor
extradite|hand over to the authorities of another country
extraneous|not belonging to that in which it is contained
extraneous|not pertinent to the matter under consideration
extricate|release from entanglement or difficulty
exuberant|joyously unrestrained
exult|feel extreme happiness or elation
facetious|cleverly amusing in tone
facet|a distinct feature or element in a problem
facile|performing adroitly and without effort
facsimile|an exact copy or reproduction
fallacious|containing or based on incorrect reasoning
fallow|left unplowed and unseeded during a growing season
falter|move hesitatingly, as if about to give way
famished|extremely hungry
fanfare|a short ceremonial tune or flourish played on brass instruments, typically to introduce something or someone important
fanfaronade|arrogant or boastful talk
farcical|broadly or extravagantly humorous
fascia|a thin sheath of fibrous tissue enclosing a muscle or other organ
fastidious|giving careful attention to detail
fatuous|devoid of intelligence
fealty|the loyalty that one owes to a country, sovereign, or lord
feckless|generally incompetent and ineffectual
fecundity|the state of being fertile; capable of producing offspring
feign|make believe with the intent to deceive
fervent|characterized by intense emotion
fete|an elaborate party, often outdoors
fetid|offensively malodorous
fetter|a shackle for the ankles or feet
fickle|liable to sudden unpredictable change
filch|make off with belongings of others
filial|designating the generation following the parental generation
filibuster|a tactic for delaying legislation by making long speeches
finagle|achieve something by means of trickery or devious methods
finesse|subtly skillful handling of a situation
finicky|fussy, especially about details
firmament|the sphere on which celestial bodies appear to be projected
firth|a long narrow estuary
fizzle|make a feeble hissing or spluttering sound
fjord|a long narrow inlet of the sea between steep cliffs
flabbergasted|as if struck dumb with astonishment and surprise
flagrant|conspicuously and outrageously bad or reprehensible
flail|thrash about
flatulence|a state of excessive gas in the alimentary canal
fledgling|young bird that has just become capable of flying
flippant|showing an inappropriate lack of seriousness
flog|beat severely with a whip or rod
florid|elaborately or excessively ornamented
flotilla|a fleet of small craft
fluvial|of or relating to a river
flux|a state of constant change
foible|a minor weakness or peculiarity in someone's character
foil|hinder or prevent, as an effort, plan, or desire
foment|try to stir up
foray|an initial attempt
forbearance|good-natured tolerance of delay or incompetence
forestall|keep from happening or arising; make impossible
forlorn|marked by or showing hopelessness
formidable|extremely impressive in strength or excellence
forswear|formally reject or disavow a formerly held belief, usually under pressure
fortuitous|lucky; occurring by happy chance
foundry|factory where metal castings are produced
fracas|a noisy quarrel
fractious|easily irritated or annoyed
fraught|marked by distress
frenetic|excessively agitated
fresco|a mural done with watercolors on wet plaster
fricassee|pieces of chicken or other meat stewed in gravy with carrots and onions and served with noodles or dumplings
frieze|an architectural ornament consisting of a horizontal sculptured band between the architrave and the cornice
frigate|a medium size square-rigged warship of the 18th and 19th centuries
frivolous|not serious in content or attitude or behavior
frugal|sparing or economical with regard to money or food
frumpy|drab, old-fashioned, and unattractive
fuchsia|a dark purplish-red color
fulcrum|the pivot about which a lever turns
fulminate|criticize severely
fulsome|unpleasantly and excessively suave or ingratiating
funicular|operating by cable with ascending and descending cars counterbalanced, especially on a mountainside
furor|an outbreak of public anger or excitement
furtive|secret and sly or sordid
fuselage|the central body of an airplane that is designed to accommodate the crew and passengers, or cargo
gaffe|a socially awkward or tactless act
galaxy|a system of millions or billions of stars, together with gas and dust, held together by gravitational attraction
gallantry|exceptional or heroic courage when facing danger
galosh|a waterproof overshoe that protects shoes from water or snow
galvanize|stimulate to action
gambit|a device, action, or opening remark, typically one entailing a degree of risk, calculated to gain an advantage
gamut|a complete extent or range
ganglion|an encapsulated neural structure consisting of a collection of cell bodies of neurons
gangplank|a temporary bridge for getting on and off a vessel at dockside
gangrene|localized death and decomposition of body tissue, resulting from either obstructed circulation or bacterial infection
garrulous|full of trivial conversation
gauche|lacking social polish
gaunt|very thin especially from disease or hunger or cold
gavel|a small mallet used by a presiding officer or a judge
gazette|a newspaper or official journal
gelding|castrated male horse
genial|diffusing warmth and friendliness
genteel|marked by refinement in taste and manners
genuflect|bend the knees and bow before a religious superior or image
geoduck|a large edible clam found burrowing deeply in sandy mud along the Pacific coast of North America
geriatric|of or relating to the aged or elderly
germane|relevant and appropriate
gerrymander|divide voting districts unfairly and to one's advantage
gerund|a noun formed from a verb
gesticulate|show, express, or direct through movement
geyser|a spring that discharges hot water and steam
gibe|an aggressive remark directed at a person like a missile
gingham|a clothing fabric in a plaid weave
girdle|a band of material around the waist that strengthens a skirt or trousers
gird|prepare oneself for action or a confrontation
gizzard|thick-walled muscular pouch below the crop in many birds and reptiles for grinding food
glean|gather, as of natural products
glib|marked by lack of intellectual depth
glower|look angry or sullen as if to signal disapproval
glutinous|having the sticky properties of an adhesive
gluttony|habitual eating to excess
gneiss|a laminated metamorphic rock similar to granite
goad|stab or urge on as if with a pointed stick
gossamer|characterized by unusual lightness and delicacy
gourmand|a person who is devoted to eating and drinking to excess
governance|the action or manner of governing
graffiti|a rude decoration inscribed on rocks or walls
grandiloquent|lofty in style
grandiose|impressive because of unnecessary largeness or magnificence
gratuitous|unnecessary and unwarranted
gratuitous|unnecessary and unwarranted
gregarious|temperamentally seeking and enjoying the company of others
gridiron|a cooking utensil of parallel metal bars; used to grill fish or meat
grimace|contort the face to indicate a certain mental state
gripe|express a complaint or grumble about something, especially something trivial
grotesque|distorted and unnatural in shape or size; abnormal and hideous
grotto|a small cave, usually with attractive features
grovel|show submission or fear
gruff|brusque and surly and forbidding
gubernatorial|relating to a state governor or the office of state governor
guffaw|a burst of loud and hearty laughter
guile|the use of tricks to deceive someone
guillotine|a machine with a heavy blade sliding vertically in grooves, used for beheading people
gullet|the passage between the pharynx and the stomach; the esophagus
gumbo|a spicy chicken or seafood soup thickened typically with okra or rice
gumption|fortitude and determination
gunnysack|a bag made of burlap
gustatory|of or relating to the sense of taste
guttural|(of a speech sound) produced in the throat; harsh-sounding
haberdashery|a store where men's clothes are sold
habilimented|dressed or clothed especially in fine attire; often used in combination
habitue|a regular patron
hackneyed|repeated too often; overfamiliar through overuse
haddock|a silvery-gray bottom-dwelling fish of North Atlantic coastal waters, related to cod
halcyon|idyllically calm and peaceful; suggesting happy tranquility
haphazardly|without care; in a slapdash manner
hapless|unfortunate and deserving pity
harangue|address forcefully
harbinger|something indicating the approach of something or someone
harlequin|a mute character in traditional pantomime, typically masked and dressed in a diamond-patterned costume
harpsichord|a clavier with strings that are plucked by plectra mounted on pivots
hashish|purified resinous extract of the hemp plant; used as a hallucinogen
haughty|having or showing arrogant superiority
hauteur|overbearing pride with a superior manner toward inferiors
hearsay|gossip passed around by word of mouth
hedonism|an ethical system that evaluates the pursuit of pleasure as the highest good
hegemony|the dominance or leadership of one social group over others
heinous|extremely wicked, deeply criminal
helm|a position of leadership
hemorrhage|the flow of blood from a ruptured blood vessel
henceforth|from this time forth; from now on
heresy|any opinions at variance with the official position
hermetic|completely sealed or airtight
heterogenous|consisting of elements that are not of the same kind
heuristic|a commonsense rule to help solve some problem
hew|strike with an axe; cut down, strike
hindrance|any obstruction that impedes or is burdensome
hinterland|a remote and undeveloped area
hirsute|having or covered with hair
histrionic|characteristic of acting or a stage performance
hoary|having gray or white hair as with age
hodgepodge|a motley assortment of things
homespun|characteristic of country life
homily|a sermon on a moral or religious topic
hominy|hulled corn with the bran and germ removed
hopscotch|a children's characterized by hopping into and over squares marked on the ground to retrieve a marker thrown into one of these squares
hortatory|giving strong encouragement
hospice|a program of medical and emotional care for the terminally ill
hovel|small crude shelter used as a dwelling
hubris|overbearing pride or presumption
hullabaloo|disturbance usually in protest
humdrum|tediously repetitious or lacking in variety
husbandry|the practice of cultivating the land or raising stock
hydrangea|a shrub native to Asia and America with rounded or flattened flowering heads of small florets
hypnagogic|sleep inducing
ichthyology|the branch of zoology that studies fishes
iconoclast|someone who attacks cherished ideas or institutions
idiosyncratic|peculiar to the individual
idolatrous|blindly or excessively devoted or adoring
idyllic|charmingly simple and serene
ignominious|deserving or bringing disgrace or shame
illustrious|widely known and esteemed
imbibe|take in liquids
imbroglio|an intricate and confusing interpersonal situation
imminent|close in time; about to occur
impasse|a situation in which no progress can be made
impecunious|not having enough money to pay for necessities
imperious|having or showing arrogant superiority
impetuous|characterized by undue haste and lack of thought
impetus|a force that moves something along
impinge|infringe upon
implicit|being without doubt or reserve
imply|express or state indirectly
impromptu|without advance preparation
impudence|the trait of being rude and impertinent
impunity|exemption from punishment or loss
impute|attribute or credit to
inane|devoid of intelligence
incendiary|a criminal who illegally sets fire to property
inchoate|only partly in existence; imperfectly formed
incipient|only partly in existence; imperfectly formed
inclement|severe, of weather
incognito|without revealing one's identity
inconspicuous|not prominent or readily noticeable
incontrovertible|impossible to deny or disprove
incorrigible|impervious to correction by punishment
incredulous|not disposed or willing to believe; unbelieving
incumbent|necessary as a duty or responsibility; morally binding
indelible|not able to be removed or erased
indemnity|protection against future loss
indigent|poor enough to need help from others
indomitable|impossible to subdue
ineffable|defying expression or description
inevitable|incapable of being avoided or prevented
inexorable|impossible to prevent, resist, or stop
infinitesimal|immeasurably small
infirmity|the state of being weak in health or body
inflammatory|arousing to action or rebellion
infringe|go against, as of rules and laws
ingot|metal that is cast in the shape of a block for convenient handling
ingrate|a person who shows no gratitude
ingratiate|gain favor with somebody by deliberate efforts
inimical|not friendly
iniquity|absence of moral or spiritual values
injunction|a judicial remedy to prohibit a party from doing something
innocuous|lacking intent or capacity to injure
innuendo|an indirect and usually malicious implication
inoculate|inject or treat with the germ of a disease to render immune
inscrutable|difficult or impossible to understand
insidious|working or spreading in a hidden and usually injurious way
insolent|marked by casual disrespect
insolvent|unable to meet or discharge financial obligations
insouciant|marked by unconcern
instigate|provoke or stir up
insular|suggestive of the isolated life of an island
insuperable|incapable of being surpassed or excelled
insurgent|in opposition to a civil authority or government
interdict|a court order prohibiting a party from a certain activity
interim|serving during an intermediate interval of time
interlocutor|a person who takes part in a conversation
interloper|someone who intrudes on the privacy or property of another
interlude|a brief show (usually music or dance) inserted between the sections of a longer performance
intimation|a slight suggestion or vague understanding
intransigent|impervious to pleas, persuasion, requests, or reason
intrepid|invulnerable to fear or intimidation
inundated|covered with water
inure|cause to accept or become hardened to
invective|abusive language used to express blame or censure
inveterate|habitual
irascible|quickly aroused to anger
irreproachable|free of guilt; not subject to blame
irreverence|a mental attitude showing lack of due respect
ischemia|inadequate blood supply to an organ or part of the body, especially the heart muscles
isosceles|(of a triangle) having two sides of equal length
isthmus|a relatively narrow strip of land (with water on both sides) connecting two larger land areas
jalopy|a car that is old and unreliable
jargon|technical terminology characteristic of a particular subject
jaundice|a medical condition with yellowing of the skin or eyes caused by obstruction of the bile duct, by liver disease, or excessive breakdown of erythrocytes
javelina|dark grey peccary with an indistinct white collar; of semi desert areas of Mexico and southwestern United States|jejune
jingoist|an extreme bellicose nationalist
jinx|bring bad luck to; cast an evil spell on
jostle|make one's way by pushing or shoving
jovial|full of or showing high-spirited merriment
jubilant|full of high-spirited delight
jugal|relating to the zygoma (the bony arch of the cheek)
junket|a trip taken by an official at public expense
junta|a group of officers who rule a country after seizing power
jurisprudence|the collection of rules imposed by authority
juxtapose|place side by side
katydid|a large, typically green, long-horned grasshopper native to North America
kayak|a canoe of a type used originally by the Inuit, made of a light frame with a watertight covering and a small opening to sit in
keloid|raised pinkish scar tissue at the site of an injury; results from excessive tissue repair
kerosene|a flammable hydrocarbon oil used as fuel in lamps and heaters
khaki|a sturdy twilled cloth of a yellowish brown color used especially for military uniforms
kismet|fate or fortune
knaidel|a type of dumpling eaten in Jewish households during Passover
knave|a deceitful and unreliable scoundrel
knell|the sound of a bell rung slowly to announce a death
knoll|a small natural hill
kumquat|an orange-like fruit related to the citruses, with an edible sweet rind and acid pulp
kylix|a shallow drinking cup with two handles; used in ancient Greece
labile|readily undergoing change or breakdown
labyrinth|complex system of paths or tunnels in which it is easy to get lost
laceration|a deep cut or tear in skin or flesh
lachrymose|showing sorrow
lackadaisical|idle or indolent especially in a dreamy way
lacking interest or significance or impact
laconic|brief and to the point
lament|express grief verbally
lampoon|a composition that imitates or misrepresents a style
languid|lacking spirit or liveliness
lapel|fold at the front of a coat; continuation of the coat collar
largesse|liberality in bestowing gifts
lassitude|weakness characterized by a lack of vitality or energy
laudable|worthy of high praise
lecherous|having or showing excessive or offensive sexual desire
lectern|desk or stand with a slanted top used to hold a text at the proper height for a lecturer
legerdemain|an illusory feat
lethargy|weakness characterized by a lack of vitality or energy
leviathan|the largest or most massive thing of its kind
levity|a manner lacking seriousness
lexicon|a reference book containing an alphabetical list of words
liaison|a means of communication between groups
libation|a serving of an alcoholic beverage
libel|a false and malicious publication
libertarian|an advocate of freedom of thought and speech
libido|a Freudian term for sexual urge or desire
licentious|lacking moral discipline
lilliputian|very small
limpid|clear and bright
linchpin|a central cohesive source of support and stability
liniment|a medicinal liquid that is rubbed into the skin to relieve muscular stiffness and pain
liqueur|strong highly flavored sweet liquor usually drunk after a meal
liquidate|convert into cash
lissome|moving and bending with ease
lithe|moving and bending with ease
litigant|a party to a lawsuit
liturgy|a rite or body of rites prescribed for public worship
livid|furiously angry
loquacious|full of trivial conversation
lucid|transparently clear; easily understandable
lucrative|producing a sizeable profit
lugubrious|excessively mournful
luminary|a celebrity who is an inspiration to others
lurid|glaringly vivid and graphic; marked by sensationalism
lustrous|reflecting light
macabre|shockingly repellent; inspiring horror
maculate|spot, stain, or pollute
maelstrom|a powerful circular current of water
magnanimous|noble and generous in spirit
mahogany|hard reddish-brown timber from a tropical tree, used for high-quality furniture
malady|any unwholesome or desperate condition
malaise|a general feeling of discomfort, uneasiness, or depression
malapropism|misuse of a word by confusion with one that sounds similar
malice|the desire to see others suffer
malingerer|someone shirking duty by feigning illness or incapacity
malleable|easily influenced
manifold|many and varied; having many features or forms
mantel|a shelf that projects from the wall above a fireplace
manumit|free from slavery or servitude
maritime|relating to ships or navigation
marmelade|a preserve made of the pulp and rind of citrus fruits
martyr|one who suffers for the sake of principle
masseuse|a female massager
matinee|a theatrical performance held during the daytime, especially in the afternoon
matriculate|enroll as a student
matrix|an enclosure within which something originates or develops
maudlin|effusively or insincerely emotional
maudlin|effusively or insincerely emotional
mausoleum|a large burial chamber, usually above ground
mauve|a pale purple to moderate greyish-violet color
maverick|someone who exhibits independence in thought and action
mawkish|effusively or insincerely emotional
maxim|a saying that is widely accepted on its own merits
melee|a noisy riotous fight
mellifluous|pleasing to the ear
melodramatic|characteristic of acting or a stage performance
menagerie|a collection of live animals for study or display
mendacious|given to lying
mendicant|a pauper who lives by begging
mercantile|relating to or characteristic of trade or traders
mercenary|a person hired to fight for another country than their own
mercurial|liable to sudden unpredictable change
meretricious|tastelessly showy
metallurgy|the science and technology of metals
mettle|the courage to carry on
mezzanine|intermediate floor just above the ground floor; the first or lowest balcony
microcosm|a miniature model of something
microfiche|small sheet of microfilm on which many pages of material have been photographed
midriff|the middle area of the human torso, usually in front
mien|a person's appearance, manner, or demeanor
milieu|the environmental condition
minx|a seductive woman who uses her sex appeal to exploit men
mirage|an optical illusion in which atmospheric refraction by a layer of hot air distorts or inverts reflections of distant objects
mirth|great merriment
misanthrope|someone who dislikes people in general
miscreant|a person without moral scruples
misnomer|an incorrect or unsuitable name
mitigate|lessen or to try to lessen the seriousness or extent of
mnemonic|of or relating to the practice of aiding the memory
modicum|a small or moderate or token amount
mohair|fabric made with yarn made from the silky hair of the Angora goat
mollify|cause to be more favorably inclined
mongrel|derogatory term for a variation that is not genuine; an inferior dog or one of mixed breed
moniker|a familiar name for a person
monolithic|characterized by rigidity and total uniformity
monotonous|sounded or spoken in a tone unvarying in pitch
monsoon|a seasonal wind in southern Asia; brings rain from the southwest in summer and from the northeast in winter
montage|a paste-up made by sticking together pieces of paper or photographs to form an artistic image
moot|of no legal significance, as having been previously decided
moraine|accumulated earth and stones deposited by a glacier
morass|a soft wet area of low-lying land that sinks underfoot
moratorium|suspension of an ongoing activity
morbid|suggesting the horror of death and decay
mores|the conventions embodying the fundamental values of a group
morose|showing a brooding ill humor
motif|a design that consists of recurring shapes or colors
motley|consisting of a haphazard assortment of different kinds
multifarious|having many aspects
multitudinous|too numerous to be counted
mundane|found in the ordinary course of events
munificent|very generous
mutiny|open rebellion against constituted authority
myriad|a large indefinite number
myrrh|aromatic resin from a tree native to the Near East that is burned as incense and used in perfume
mystique|an aura of heightened value or interest or meaning surrounding a person or thing
nadir|the lowest point of anything
naivete|lack of sophistication or worldliness
napalm|gasoline jelled with aluminum soaps; highly incendiary liquid used in fire bombs and flamethrowers
narcissist|someone who is excessively self-centered
nascent|being born or beginning
naught|a quantity of no importance
nauseate|upset and make ill
nautical|relating to ships or navigation
navel|a scar where the umbilical cord was attached; bellybutton
nebulous|lacking definite form or limits
necessitate|require as useful, just, or proper
necromancy|the belief in magical spells that harness occult forces
nefarious|extremely wicked
negligent|characterized by undue lack of attention or concern
neophyte|any new participant in some activity
nepotism|favoritism shown to relatives or friends by those in power
nestle|move or arrange oneself in a comfortable and cozy position
newfangled|(of a new kind or fashion) gratuitously new
nexus|the means of connection between things linked in series
nicety|conformity with some standard of correctness or propriety
niche|a position well suited to the person who occupies it
nihilism|the delusion that things do not exist
nincompoop|a foolish or stupid person
nirvana|any place of complete bliss and delight and peace
noetic|of or associated with or requiring the use of the mind
noisome|offensively malodorous
nomadic|migratory
nomenclature|a system of words used to name things in a discipline
nonchalant|marked by casual unconcern or indifference
nonpareil|colored beads of sugar used as a topping; sprinkles
nonplus|be a mystery or bewildering to
nostalgia|a longing for something past
nostrum|patent medicine whose efficacy is questionable
notoriety|the state of being known for some unfavorable act or quality
noxious|injurious to physical or mental health
nuance|a subtle difference in meaning or opinion or attitude
nubile|(of young women) attractive and eligible to marry
nugatory|of no real value
nuisance|anything that disturbs, endangers life, or is offensive
numismatist|a collector and student of money, especially coins
nuptial|of or relating to a wedding
oaf|a stupid, uncultured, or clumsy person
oasis|a shelter serving as a place of safety or sanctuary
obdurate|stubbornly persistent in wrongdoing
obeisance|bending the head or body in reverence or submission
obfuscate|make obscure or unclear
oblique|not direct, explicit, or straightforward
oblivious|lacking conscious awareness of
oblong|deviating from a square or circle or sphere by being elongated in one direction
obloquy|state of disgrace resulting from public abuse
obscene|(of the portrayal or description of sexual matters) offensive or disgusting by accepted standards of morality and decency
obsequious|attentive in an ingratiating or servile manner
obsolete|no longer in use
obstinate|marked by tenacious unwillingness to yield
obstreperous|noisily and stubbornly defiant
obstruct|block passage through
obtrusive|undesirably noticeable
obtuse|slow to learn or understand; lacking intellectual acuity
obviate|prevent the occurrence of; prevent from happening
occlude|block passage through
occult|supernatural practices and techniques
ochre|an earthy pigment containing ferric oxide, typically with clay, varying from yellow to orange or red
odious|unequivocally detestable
odium|hate coupled with disgust
odoriferous|having a natural fragrance
odyssey|a long wandering and eventful journey
officious|intrusive in a meddling or offensive manner
ogle|stare or look at, especially with amorous intentions
olfactory|of or relating to the sense of smell
ombudsman|a government appointee who investigates complaints by private persons against the government
ominous|threatening or foreshadowing evil or tragic developments
omit|leave undone or leave out
omniscient|infinitely wise
onerous|burdensome or difficult to endure
onomatopoeia|using words that imitate the sound they denote
onslaught|a rapid and continuous outpouring
onus|a burdensome or difficult concern
opalescent|having a play of lustrous rainbow colors
opaque|not transmitting or reflecting light or radiant energy
opportune|suitable or advantageous especially for a particular purpose
opprobrium|state of disgrace resulting from public abuse
opulent|rich and superior in quality
opus|a musical work that has been created
oracle|an authoritative person who divines the future
orifice|an opening, especially one that opens into a bodily cavity
oriole|a New World bird of the American blackbird family, with black and orange or yellow plumage
orotund|full and rich, of sounds
oscillate|move or swing from side to side regularly
osseous|composed of or containing bone
ossify|make rigid and set into a conventional pattern
ostensible|appearing as such but not necessarily so
ostentatious|tawdry or vulgar
ostracism|the act of excluding someone from society by general consent
otiose|serving no useful purpose; having no excuse for being
oust|remove from a position or office
outage|a temporary suspension of operation
outlandish|noticeably or extremely unconventional or unusual
overt|open and observable; not secret or hidden
ovolo|a convex molding having a cross section in the form of a quarter of a circle or of an ellipse
ovoviviparous|producing living young from eggs that hatch within the body
oxbow|a U-shaped curve in a river or a stream
oxymoron|conjoined contradictory terms
paddock|pen where racehorses are saddled and paraded before a race
pagoda|an Asian temple; usually a pyramidal tower with an upward curving roof
palliate|lessen or to try to lessen the seriousness or extent of
pallid|abnormally deficient in color as suggesting physical or emotional distress
palpable|able to be felt by tactile examination
paltry|(of an amount) small or meager
panacea|hypothetical remedy for all ills or diseases
panache|distinctive and stylish elegance; a feathered plume on a helmet
pandemonium|a state of extreme confusion and disorder
paradigm|a standard or typical example
paragon|model of excellence or perfection of a kind
parasol|a handheld collapsible source of shade; a sun umbrella
pariah|a person who is rejected from society or home
parquetry|a patterned wood inlay used to cover a floor
parsimonious|excessively unwilling to spend
parsnip|long tapering cream-colored root with a sweet flavor
partisan|a fervent and even militant proponent of something
pastoral|idyllically rustic
patina|a green or brown film on the surface of copper, bronze or similar metals, produced by oxidation over a long period
paucity|an insufficient quantity or number
paunch|a protruding abdomen
peccadillo|a petty misdeed
pecuniary|relating to or involving money
pedagogy|the principles and methods of instruction
pedantic|marked by a narrow focus on or display of learning
peeve|an annoyed or irritated mood
pejorative|expressing disapproval
pellucid|transparently clear; easily understandable
penchant|a strong liking
penitent|feeling or expressing remorse for misdeeds
penurious|excessively unwilling to spend
percolate|filter gradually through a porous surface or substance
peremptory|putting an end to all debate or action
perfidious|tending to betray
perfunctory|hasty and without attention to detail; not thorough
peril|a state of danger involving risk
pernicious|exceedingly harmful
perquisite|an incidental benefit awarded for certain types of employment, especially when regarded as a right
pertinacious|stubbornly unyielding
pertinent|having precise or logical relevance to the matter at hand
pert|characterized by a lightly saucy or impudent quality
peruse|examine or consider with attention and in detail
pervasive|spreading or spread throughout
petulant|easily irritated or annoyed
pewter|a gray alloy of tin with copper and antimony
philanthropic|of or relating to charitable giving
phlegmatic|showing little emotion
phosphorescence|a fluorescence that persists after the bombarding radiation has ceased
pidgin|an artificial language used for trade between speakers of different languages
pillage|steal goods; take as spoils
pinion|a small gear or spindle engaging with a large gear; the outer part of a bird's wing including the flight feathers
pinnacle|the highest level or degree attainable
pious|having or showing or expressing reverence for a deity
piquant|having a pleasantly sharp taste or appetizing flavor
pirouette|a rapid spin of the body, especially on the toes as in ballet
pithy|concise and full of meaning
pittance|an inadequate payment
placate|cause to be more favorably inclined
placid|calm and free from disturbance
plaintiff|a person who brings an action in a court of law
platitude|a trite or obvious remark
plaudit|enthusiastic approval
plebeian|one of the common people
plenary|full in all respects
plenitude|a full supply
plethora|extreme excess
pliable|easily bent; flexible
plight|a situation from which extrication is difficult
plummet|drop sharply
plunder|destroy and strip of its possession
plutocracy|a political system governed by the wealthy people
poignant|keenly distressing to the mind or feelings
poinsettia|a small Mexican shrub with large showy scarlet bracts surrounding the small yellow flowers, popular as a houseplant at Christmas
pompous|puffed up with vanity
pontifical|characterized by a pompous and superior air of infallibility
pontoon|a flat-bottomed boat or hollow metal cylinder used with others to support a temporary bridge or floating landing stage
portent|a sign of something about to happen
posthumous|occurring, awarded, or appearing after the death of the originator
postulate|suggest or assume the existence, fact, or truth of something as a basis for reasoning, discussion, or belief
potentate|a powerful ruler, especially one who is unconstrained by law
potpourri|a mixture of dried petals and spices placed in a bowl or small sack to perfume clothing or a room
pragmatic|concerning a theory of observable practical consequences
preamble|a preliminary introduction, as to a statute or constitution
precarious|fraught with danger
precipitous|dangerously high or steep; done suddenly and without careful consideration
preclude|make impossible, especially beforehand
precocious|characterized by exceptionally early development
predecessor|one who goes before you in time
predilection|a predisposition in favor of something
premonition|a feeling of evil to come
preponderance|exceeding in heaviness; having greater weight
preposterous|inviting ridicule
prerogative|a right reserved exclusively by a person or group
presage|a foreboding about what is about to happen
prescience|the power to foresee the future
prevaricate|be deliberately ambiguous or unclear
pristine|completely free from dirt or contamination
privy|informed about something secret or not generally known
probity}complete and confirmed integrity
proclivity|a natural inclination
prodigal|recklessly wasteful
prodigious|great in size, force, extent, or degree
profligate|unrestrained by convention or morality
prognosticate|make a prediction about; tell in advance
prolific|intellectually productive
prolix|tediously prolonged or tending to speak or write at length
promulgate|state or announce
propensity|a natural inclination
propitious|presenting favorable circumstances
proprietor|someone who owns a business
prosaic|not challenging; dull and lacking excitement
proscribe|command against
prostrate|lying face downward
protean|taking on different forms
protege|a person who receives support from an influential patron
proverbial|relating to or resembling a condensed but memorable saying
prowess|a superior skill learned by study and practice
prurient|characterized by lust
psalm|a sacred song or hymn
puce|a dark red or purple-brown color
puerile|displaying or suggesting a lack of maturity
pugilist|someone who fights with his fists for sport
pugnacious|ready and able to resort to force or violence
puissant|having great power or influence
pulchritude|physical beauty, especially of a woman
pumice|a very light and porous volcanic rock formed when a gas-rich froth of glassy lava solidifies rapidly
pumpernickel|dark, dense German bread made from coarsely ground whole-grain rye
punctilious|marked by precise accordance with details
pundit|an expert in a particular subject or field who is frequently called on to give opinions about it to the public
purveyor|a person who sells or deals in particular goods
pusillanimous|lacking in courage, strength, and resolution
putrid|(of organic matter) decaying or rotting and emitting a fetid smell
pylon|a tower used for carrying power lines high above the ground
quadruped|an animal especially a mammal having four limbs
quaff|swallow hurriedly or greedily or in one draught
quagmire|a soft wet area of low-lying land that sinks underfoot
quaint|attractively old-fashioned
qualm|uneasiness about the fitness of an action
quandary|state of uncertainty in a choice between unfavorable options
quarry|a surface excavation for extracting stone or slate
quash|put down by force or intimidation
quay|wharf usually built parallel to the shoreline
quell|suppress or crush completely
quench|put out, as of fires, flames, or lights
querulous|habitually complaining
query|pose a question
queue|form a line or stand in line
quibble|argue over petty things
quiche|a baked flan or tart with a savory filling thickened with eggs
quiescent|being quiet or still or inactive
quintessence|the most typical example or representative of a type
quisling|someone who collaborates with an enemy occupying force
quiver|shake with fast, tremulous movements
quixotic|not sensible about practical matters
quorum|a gathering of the minimal number of members of a group
quotidian|found in the ordinary course of events
racketeer|a person who engages in dishonest and fraudulent business dealings
raconteur|a person skilled in telling anecdotes
rambunctious|noisy and lacking in restraint or discipline
rambutan|a red, plum-sized tropical fruit with soft spines and a slightly acidic taste
ramification|a consequence, especially one that causes complications
rampant|occurring or increasing in an unrestrained way
ramshackle|(especially of a house or vehicle) in a state of severe disrepair
rancid|(of foods containing fat or oil) smelling or tasting unpleasant as a result of being old and stale
rancor|a feeling of deep and bitter anger and ill-will
rappel|lower oneself with a rope coiled around the body from a mountainside
rapport|a relationship of mutual understanding between people
rapprochement|an establishment or resumption of harmonious relations, especially in international relations
rarefied|of high moral or intellectual value
ratify|approve and express assent, responsibility, or obligation
raucous|making or constituting a disturbingly harsh and loud noise
ravage|cause extensive destruction or ruin utterly
rayon|a textile fiber or fabric made from regenerated cellulose (viscose)
rebuff|reject (someone or something) in an abrupt or ungracious manner
rebuke|an act or expression of criticism and censure
recalcitrant|stubbornly resistant to authority or control
recant|formally reject or disavow a formerly held belief
recapitulate|summarize briefly
receptacle|an object or space used to contain something
recidivism|habitual relapse into crime
recluse|one who lives in solitude
recoil|draw back, as with fear or pain
recommence|begin again
recompense|payment or reward, as for service rendered
reconcile|bring into consonance or accord
recondite|difficult to understand
reconnaissance|the act of scouting
recrimination|mutual accusations
rectitude|righteousness as a consequence of being honorable and honest
redoubtable|inspiring fear
redress|act of correcting an error or a fault or an evil
redundant|not or no longer needed or useful; superfluous
refulgent|radiating or as if radiating light
refurbish|improve the appearance or functionality of
refutation|the act of determining that something is false
regalia|the distinctive clothing worn and ornaments carried at formal occasions as an indication of status
regatta|a sporting event consisting of a series of boat or yacht races
reggaeton|a form of dance music of Puerto Rican origin, characterized by a fusion of Latin rhythms, dancehall, and hip-hop or rap
regicide|the action of killing a king
regime|the governing authority of a political unit
registrar|an official responsible for keeping a register or official records
regress|get worse or fall back to a previous condition
reiterate|say, state, or perform again
rejoinder|a reply, especially a sharp or witty one
relegate|assign to a lower position
relent|give in, as to influence or pressure
relic|an object surviving from an earlier time, especially one of historical or sentimental interest
relinquish|turn away from; give up
remediate|set straight or right
remiss|failing in what duty requires
remorse|a feeling of deep regret, usually for some misdeed
remunerate|make payment to; compensate
rendezvous|a meeting at an agreed time and place, typically between two people
renegade|someone who rebels and becomes an outlaw
renege|fail to fulfill a promise or obligation
renunciation|the act of sacrificing or giving up or surrendering
repercussion|a remote or indirect consequence of some action
repertoire|the range of skills in a particular field or occupation
replete|filled or well-supplied with something
repository|a place, building, or receptacle where things are or may be stored
repossess|retake possession of something when a buyer defaults on payments
reprehensible|bringing or deserving severe rebuke or censure
reprieve|postpone the punishment of a convicted criminal
reproach|address someone in such a way as to express disapproval or disappointment
reprobate|a person without moral scruples
reprove|reprimand, scold, or express dissatisfaction with
repudiate|reject as untrue, unfounded, or unjust
repugnant|offensive to the mind
requiem|a Mass for the repose of the souls of the dead; an act or token of remembrance
requiescat|a wish or prayer for the repose of a dead person
requisition|an authoritative demand
rescind|cancel officially
resolute|firm in purpose or belief
restitution|a sum of money paid in compensation for loss or injury
restive|impatient especially under restriction or delay
resuscitate|cause to regain consciousness
reticent|cool and formal in manner
retinue|a group of advisers, assistants, or others accompanying an important person
retort|answer back
retract|formally reject or disavow
retrench|make a reduction, as in one's workforce
retribution|the act of taking revenge
revelation|an enlightening or astonishing disclosure
revelry|unrestrained merrymaking
reverberate|ring or echo with sound
revere|love unquestioningly and uncritically or to excess
reverie|a state of being pleasantly lost in one's thoughts; a daydream
revile|spread negative information about
revue|a light theatrical entertainment consisting of a series of short sketches, songs, and dances, typically satirical
revulsion|intense aversion
rhetorical|relating to using language effectively
rheumatism|any disease marked by inflammation and pain in the joints, muscles, or fibrous tissue
ribald|referring to sexual matters in an amusingly coarse or irreverent way
ricochet|(of a bullet, shell, or other projectile) rebound one or more times off a surface
rife|excessively abundant
risque|slightly indecent and liable to shock, especially by being sexually suggestive
rivet|a short metal pin or bolt for holding together two plates of metal, its headless end being beaten out or pressed down when in place
robust|sturdy and strong in form, constitution, or construction
rostrum|a raised platform on which a person stands to make a public speech, receive an award or medal, play music, or conduct an orchestra
rotisserie|a cooking appliance with a rotating spit for roasting and barbecuing meat
rotunda|a round building or room, especially one with a dome
rubella|a contagious viral disease, with symptoms like mild measles
rudimentary|being in the earliest stages of development
ruminate|reflect deeply on a subject
rutabaga|a cruciferous plant with a thick bulbous edible yellow root
sanctimonious|excessively or hypocritically pious
sanguine|confidently optimistic and cheerful
scurrilous|expressing offensive reproach
semaphore|an apparatus for visual signaling
serendipity|good luck in making unexpected and fortunate discoveries
sobriety|the state of being unaffected or not intoxicated by alcohol
solicitous|full of anxiety and concern
solipsism|the philosophical theory that the self is all that exists
spurious|plausible but false
staid|characterized by dignity and propriety
stolid|having or revealing little emotion or sensibility
subjugate|make subservient; force to submit or subdue
surfeit|indulge (one's appetite) to satiety
surreptitious|marked by quiet and caution and secrecy
swarthy|naturally having skin of a dark color
tangential|of superficial relevance if any
tirade|a speech of violent denunciation
toady|a person who tries to please someone to gain an advantage
tome|a large and scholarly book
torpid|in a condition of biological rest or suspended animation
travesty|a composition that imitates or misrepresents a style
trenchant|having keenness and forcefulness and penetration in thought
trite|repeated too often; overfamiliar through overuse
truculent|defiantly aggressive
turpitude|a corrupt or depraved or degenerate act or practice
ubiquitous|being present everywhere at once
umbrage|a feeling of anger caused by being offended
upbraid|express criticism towards
utilitarian|having a useful function
veracity|unwillingness to tell lies
vestige|an indication that something has been present
vicissitude|a variation in circumstances or fortune
vilify|spread negative information about
virtuoso|someone who is dazzlingly skilled in any field
vitriolic|harsh, bitter, or malicious in tone
vituperate|spread negative information about
vociferous|conspicuously and offensively loud
waft|be driven or carried along, as by the air
wanton|a lewd or immoral person
welter|a confused multitude of things
wheedle|influence or urge by gentle urging, caressing, or flattering
whittle|cut small bits or pare shavings from
wily|marked by skill in deception
winsome|charming in a childlike or naive way
wraith|a mental representation of some haunting experience
wrangle|quarrel noisily, angrily, or disruptively
xanthic|of a yellow or yellowish color
xeric|being deficient in moisture
xiphoid|sword-shaped
yarmulke|a skullcap worn by religious Jews, especially at prayer
yeoman|a free man who cultivates his own land
yoke|join with stable gear, as two draft animals
zealot|a fervent and even militant proponent of something
zenith|the point above the observer directly opposite the nadir
zephyr|a slight wind
